99999999999999999001000000000000000000000000000999
00002060099999999000000099999999999999999000000999
40002000099999999000600099999999999999999000006999
00000000099999999000000096000000000000099000200999
20000000099999999000000090060000000000099000000999
00006000099999900000000090000000000000099000000999
06000000099999909000000090000200000000699200000999
00000000299999900000600090000000006000099000000999
00000000099999999099909090000000000000099000000999
00000000099999906000000000000000000000000002000999
00000000099999900000999990000000001000099000000999
00000000099999900000999990000002060000099000060999
00000000099900000000999990000000000000099999999999
99909999999909960000000000999900999999999999999999
99900009002009900000000060999900999999999999999999
99999900000009909909000000999900999999999999999999
99999999000009900009000000999900999999900000000000
99999999600069999999000000999900999999900000000000
99999999006009999999006000999900999999900000000000
99999999000009999999000000999900999999900000000000
99999999999900000999000000999900999999900000000000
99999999999920000999000000999900999999900060000000
99999999999960000999000000999900999999900000000000
99999999999900000999999999999900999999900200000000
99999999999900006999999999999900999999900000000000
99999999999900000999999999000000999999900000000000
99999999999900000999999999000020000000000000060000
00000000100000000999999999000000099999000000000000
00000000006009990000000009006000090000000000000000
00000006600009990999999909006000090000000000000000
00000020000000000002000909000000090000060099999999
00006000000000000000600009000000090000000009999999
00600000000000200000000909000000090000060009999999
00000000000000000000000909000000090000000009999999
00000010000066000000000900000000000000000000000000
00000000000009999999999999000000090000000099009090
10000000000009999999999999000000999999099900000000
00000000000009999999999999000000900000000000000000
00000000000009999999999999200000900000099900300000
00000000200009999999999999999990900000699900001000
00000000010009999999999999999990900000699900000000
99999999999999999999999999999990900000099900000000
99999999999999999999999999999990900000000900000000
99999999999999999999999999999990900000090999099999
99999999999999999999999999999990900000090000099999
99999999999999999999999999999990900020099999999999
99999999999999999999999999999990000000099999999999
99999999999999999999999999999999900600099999999999
99999999999999999999999999999999900000099999999999
99999999999999999999999999999999906000099999999999
