99999999999999006000009999999999999990000000000000
99999999900030000000009999999999999990020600000000
99999999900000000000009999999999999990200060006000
99999999900000000000009999999999999990000000000060
99999999900600000000009999999999999990000660002000
99999999900000000006009999999999999990000000000000
99999999900000000100009999999999999990000000000000
99999999960006000000009999999999999990000000000000
99999999900000020000009999999999999990000000000001
99999999900000000000000002600000000090000000000000
99999999900000000000000000000000000090000120000000
99999999900002069999990000000000000090600000000000
99999999900000060000000000000000000099999999990999
99999999900000009999090000000000000000000000000999
00000000000200009999096000000000606090999909999999
09999990999909000600090060010000000090900000099999
00000000009909000000090000000000000090900000099999
00600000609909000000090000000000000090960060099999
00000000009909001000090000000000000090900001099999
00000000009909000000090000020000000090900000099999
00000000009909000000090000000000000090000000099999
99009090999909000000090000001000000000000000099999
06000090999909000000099999999990000060000099999999
00000090999900000000099999999990060000000099999999
00000090999999000006099999999990000000000099999999
00000090999999999999099999999992000000000000600000
60000090999999999999099999999990000000000000000000
00000090000000000000099999999999999999900000000000
99999090999999990000000000099999999999900000000000
99900000000600000000200000099999999999900066000000
99900000000600000000000000699999999999900000000000
99900000000060000000006000099999999999900000006006
99910000000000000000000000099999999999960000000000
99900000000000000000000000099999999999900000000000
99900000000000060002000000099999999999900010000060
99900000000000000000000000199999999999900000000000
99900000000000000000000000099999999999900000000000
99999090000000000000000000000000000000000999999999
99999090000000000000000000000000000000000999999999
99999090000060000000000000001000000000000999999999
99999090000200000000000010000000000600000000000000
99999000000600000999099999000000000000000000006000
99999990000000000999000000000000000000000000000000
99999990000000000999999999006000000000100000046000
99999990000000000999999999000000000000000000000000
99999990000000000999999999000000000000600000000600
99999990000000000999999999000000000000000000000060
99999999999999999999999999006000000000020000000106
99999999999999999999999999000000000000000999999999
99999999999999999999999999000000000000000999999999