99999999999999999999999999000006999999999990000099
99999999999999999999999999000000999999999996000099
99999999999999999000000000000000900000000090040099
99999999999999999099999999006000009999900090000099
99999999999999999006000099000000999000000000000099
99999000000000999000000099999999999000000000000099
99999099999990999000000099999999999020006090000099
99000000000000099600000099999999999000000090060099
99000000000000099000020099999999900000000090000099
99000000000000099000000099999999909000000090000099
99001000000000099000000099999999909000000699999999
99000000006000099000000099999999909999999099999999
99000000000000099010000699999999909999999000099999
99000000000000099000000099999900600699999999099999
99000000000100099000000099999900000000900000000009
99000000000000099000000099999900000090909000000009
99000006060020000000000099990000000190909000600009
99990099999990990000000699990900002090909000000009
99990000000000000000000000000000006090909000000009
99999999999090000000099990000000000090909000000009
99999999900006000999999990000000010000909000000069
99999999900000000999999990000000000099900999999999
99999990000000010999999990000009999999990999999999
99999990900202009999999990000600000000000000000000
99999990900000009999999990000099999990000000000000
99999990900000069999999996000099999990000000000000
99999990900000209999999990000099999990010000000001
99999990900000009999999990000099999990000000000000
99999990900000009999999990000099999990000000000060
99999990000000009999999999990999999990000000000000
99999999999090000000000999990000000000000000000000
99999999999090000000000999999999999900000000006000
99999999999090206000000999900000000009099099009009
99999999999090000000000000000000600000000000000009
99990000000000000000000909900000000009000000000009
99991000300000000000006909900000000000000000006009
99990000066000060000000909900000000009000000000069
99990000100000000000000909900000000009000000000009
99990000000000000000000909900060000009000000000009
99990000000000000000000009902000060000099999999999
99990000000000000000000999900000660009999999999999
99990000000000060000000999900000000009999999999999
99999999999000000000002999900000000009999999999999
99999999999999999999999999999099090999999999999999
99999999999999999999999999900000000999999999999999
99999999999999999999999999900000000999999999999999
99999999999999999999999999901000000999999999999999
99999999999999999999999999900660000999999999999999
99999999999999999999999999900000000999999999999999
99999999999999999999999999900000000999999999999999
